
CabbarKaportacı	Master
AjdarMekanik	Master
DSDD	Elektrikci	Senior
aSdadad	Kaportacı	Junior
Furkan	Elektrikci	Master
SFSFS	Mekanik	Junior
Alaalal	Elektrikci	Junior
DAFAFAF	Kaportacı	Master
mafmafımafmı	Elektrikci	Senior
dmıawmıawdmıadwm	Mekanik	Master
dmafmıamıf	Mekanik	Junior
aNAANFNMAANFKAF	Kaportacı	Master
Dayın	Kaportacı	Master
Teyzen	Elektrikci	Junior
Yeğeninn	Mekanik	Senior
GIGSIGI	Kaportacı	Master
dnsgıagımnısg	Mekanik	Senior
ofamemamdfgmaoı	Elektrikci	Junior
ANANANA	Mekanik	Junior
aıgmaıgıgaj	Kaportacı	Master
fmıagmıfaımgagmımı	Elektrikci	Senior
ıgaıkgaıkg	Kaportacı	Master
gfosgmohsmo	Elektrikci	Master
afafaf	Elektrikci	Master